NO ./path_to_the_north_texture
SO ./path_to_the_south_texture
WE ./path_to_the_west_texture
EA ./path_to_the_east_texture

F 149,165,149
C 176,196,222



11111111111111111111
10000000001000000001
10000000000000000001
1000000010S010000001
10000000000000000001
10000000001000000001
11111111111111111111
