NO ./path_to_the_north_texture
SO ./path_to_the_south_texture
WE ./path_to_the_west_texture
EA ./path_to_the_east_texture
F 149,165,149
C 176,196,222
111111111111111111
1000000000000000S1
100110000000000001
100110000000000001
100000000000000001
100000000000000001
100000000000000001
100000000000000001
100000000000000001111111111111
100000000000000000000000000001
100000000000000000000000000001
100000000000000000000000000001
100000000000000001111111111111
111111111111111111
