NO ./path_to_the_north_texture
SO ./path_to_the_south_texture
WE ./path_to_the_west_texture
EA ./path_to_the_east_texture

F 149,165,149
C 176,196,222

1111111111
10000000S1
1001100001
1001100001
1000000001
1111111111
