NO ./path_to_the_north_texture
SO ./path_to_the_south_texture
WE ./path_to_the_west_texture
EA ./path_to_the_east_texture

F 149,165,149
C 176,196,222

11111111111111111111111111111111111111111111111111111111
10000000000000000000000000000000000000000000000000000001
10000000000000000000000000000000000000000000000000000001
10000000000000000111111111111111111111100000000000000001
10000000000000000111111111111111111111100000000000000111
11111111111111111111111111111111110000000000000000000001
11111111111111111111111111111111110000000000000000000001
11111111111111111111111111111111110000000000000100000001
11111111111111111111111111111111110000000000000100000001
11111111111111111111111111111111110000000000000100000001
11111111111111111111111111111111110000000000000111110001
11111111100000000010000000000000000000000000000000000001
11111111100000000010000000000000000000000000000000000001
11111111100000000010000000000000000000000000000000000001
1111111110000000001000000000000000000000S000000000000001
11111111100000000010000000000000000000000000000000000001
11111111100000000010000000000000000000000000000000000001
11111111100000000010000000000000000000000000000000000001
11111111100000000010000000000000000000000000000000000001
11111111100000000010000000000000000000000000000000000001
11111111100000000010000000000000000000000000000000000001
11111111100000000000000000000000000000000000000000000001
11111111100000000000000000000000010000000000000000000001
11111111100000000000000000000000010000000000000000000001
11111111100000000001111111111111111111111111111111111111
11111111111111111111111111111111111111111111111111111111

