NO ./SAMPLE/CONSOLE_1B.PNG
SO ./SAMPLE/CRATE_2C.PNG
WE ./SAMPLE/DOOR_1A.PNG
EA ./SAMPLE/DOOR_4A.PNG

F 149,165,14
C 176,196,222
1111111
1000001
1011101
00  1000
1011101
1N00001
1111111